1111111111111111111
1CCCCCCCC1CCCCCCCC1
1C11C111C1C111C11C1
1CCCCCCCCECCCCCCCC1
1C11C1C11111C1C11C1
1CCCC1CCC1CCC1CCCC1
1111C111C1C111C1111
1111C100000001C1111
1A00C001AAA100C00A1
1111C101111101C1111
1111C100000001C1111
1CCCCCC11111CCCCCC1
1C11C1CCC1CCC1C11C1
1CC1C111C1C111C1CC1
11CCCCCCCCCCCCCCC11
1CC111CC111CC111CC1
1C11111CC1CC11111C1
1CCCCCCCCPCCCCCCCC1
1111111111111111111
