1111111111111111111111111111111111111111
1000001C10001000100000000000000000000001
10101010101C1010101111111111111111111101
101010101011101C101C10000000000000000001
1010101010001011101010111111111111111101
101010101010001000101000011100000000C101
1010101000111110111011010000011111111101
1010101010100010111000011111110000000101
1010101110101010111111111111110111110101
10101010001C1010100000000000010000010101
1010101011111010101111111111011111010101
10101010100010101010000000C1000000010101
1010100010101010101011111111111111110101
1010111110100010001000000000000000000101
1010000000111111111111111111011111111101
1P110111100000000000000000000111111E0001
1111011111111110111111011111011111111111
1C110111111111100111100111110111111C1111
1011011111111111001100111111011111101111
10000111111111111C00C1111111000000001111
1111111111111111111111111111111111111111
