NO      ./assets/textures/env/1.xpm
SO      ./assets/textures/env/2.xpm
WE      ./assets/textures/env/3.xpm
EA      ./assets/textures/env/4.xpm

GR      ./assets/textures/env/ground.xpm

CR      ./assets/textures/gun/vandal/cross.xpm

F       140,140,140
C       180,240,255

                        1111
          111111111111111001
          101000000000011001
          100000000000011011
          100000100000011001
          100000000000000001
          100000000000011001
          101011110000011001
      1111101000000000011001
      100000111111111D111001
      101110000000010N0110011111111111111
      101 1011000000000110010000000000001
      101 1111000001000100000000000000001
      101    1001111000100010001000000001 111111
      10111111001  10001111111111111001111100001
      10000000001  100000001       1000000000001
11111110111111111  100010001       1000111000001111
10000000001        111110011111111111001 1000000001
1000000000111      111110000000000000001 1000000001
10000000000011111  100011000000000000001 1000000001
1000000000101100111100010000000000001001 1000000001
100000000010000000000001000000000011111111000000001
11111111001000000000000000000000001     10000000001
       1001111101111000100000000001     10000000001111111
       1001 100001 1111110000000001     10000000000000001
       1011 100001     100000000001     11000000000000001
       1011 100001     111111111011      1000000000000001
       1001 100001            10001      1000000000000001
       10011111D11111         10001      1000000000111111
       1001110000010111111    1001111111110000000001
       1001000000000010001    1100000000000000000001
       1000000000000000001    1100000011111111111111
       1001010000001010001    100000001
       1111011111111010011    100000001
          10000000010100111111100000001
          10000000010100000000000000001
          11000000000100000000000110001
          10000110000111111111111111111
          100000000001
          100000000001
          110111110111
          10000000001
          10000000001
          10000000001
          11111111111
