NO      ./assets/textures/test/north.xpm
SO      ./assets/textures/test/south.xpm
WE      ./assets/textures/test/west.xpm
EA      ./assets/textures/test/east.xpm

F       80,45,10
C       180,240,255

                        1111
          111111111111111001
          101000000000011001
          100000000000011011
          100000100000011001
          100000000000000001
          100000000000011001
          101011110000011001
      1111101000000000011001
      1000001111111110111001
      10111000000001000110011111111111111
      101 1011000000000110010000000000001
      101 1111000001000100000000000000001
      101    1001111000100010001000000001 111111
      10111111001  10001111111111111001111100001
      10000000001  100000001       1000000000001
11111110111111111  100010001       1000111000001111
10000000001        111110011111111111001 1000000001
1000000000111      111110000000000000001 1000000001
10000000000011111  100011000000000000001 1000000001
1000000N00101100111100010000000000001001 1000000001
100000000010000000000001000000000011111111000000001
11111111001000000000000000000000011     10000000001
       1001111101111000100000000001     10000000001111111
       1001 100001 1111110000000001     10000000000000001
       101  100001     100000000001     11000000000000001
       101  100001     111111111011      1000000000000001
       1001 100001           100001      1000000000000001
       10011111011111        100001      1000000000111111
       1001110000010111111   10001111111110000000001
       1001000000000010001   11000000000000000000001
       1000000000000000001   11000000011111111111111
       1001010000001010001   1000000001
       11110111111110100111  1000000001
          10000000010100111111000000001
          10000000010100000000000000001
          11000000000100000000000110001
          10000110000111111111111111111
          100000000001
          100000000001
          110111110111
          10000000001
          10000000001
          10000000001
          11111111111