NO	./assets/textures/test/north.xpm
SO	./assets/textures/test/south.xpm
WE	./assets/textures/test/west.xpm
EA	./assets/textures/test/east.xpm

F	220,100,0
C	220,100,0

1111111111111111111111111
1000000000000000000000001
1000000000000000000000001
1000000000000000000000001
1000000000000000000000001
1000000000000000000000001
1000000000011100000000001
1000000000010100000000001
1000000000011100000000001
1000000000000000000000001
1000000000000000000000001
1000000000000000000000001
100000000000N000000000001
1000000000000000000000001
1111111111111111111111111
