111111111111111111111
1P00000000000000001A1
111111111000011000101
1A111111100011A0000C1
100011100001111111011
1C00100000011C00000A1
111000000001111111111
1111100000000111A00C1
111111100000000100001
1E0000000000000000001
111111111111111111111
