111111111111111
1P00000000000E1
100111000100111
1000000011001C1
100000000000111
100000000000001
100000000000001
111111111111111
